NO               ./path_to_the_north_texture                            
                WE             ./path_to_the_west_texture


F  1,            234       ,5           










                   SO             ./path_to_the_south_texture
C 225 ,              3      ,            0 

EA ./path_to_the_east_texture

11111
10N01
11111
