NO               ./path_to_the_north_texture                            
                WE             ./path_to_the_west_texture


F  92,            92       ,115           






                   SO             ./path_to_the_south_texture
C 51 ,              156      ,            255 

EA ./path_to_the_east_texture


111111111111111111111111111111111
100000000000000000000000000000001
111111111111111111111111111111111
         111111111111111111111111
         100000000011000000000001
         101100000111000000000001
         100100000000000000000001
111111111111000001110000000000001
100000000011000001110111111111111
11110111111111011100000010001    
11110111111111011101010010001    
11000000110101011100000010001    
10000000000000000110000001001    
1000E000000000001101010010001    
11000001110101011111011110001    
11110111 1110101 101111010001    
11111111 1111111 111111111111    
