NO ./texture_XPM/north.xpm                       
WE ./texture_XPM/west.xpm 
EA ./texture_XPM/east.xpm 
SO ./texture_XPM/south.xpm


F 93, 93, 93
C  0, 96, 253

111111111

   111111111
   111    11
   111111111

11111111111111111111111111111111111111111111111111111111111111111111111111111111111111111111111111111111111111111111111111111111111111111111111111111111111111111111111111111111
10000S00000000000000000000000000000000000000000000000000000000000000000000000000000000000000000000000000000000000000000000000000000000000000000000000000000000000000000000000001
11111111111111111111111111111111111111111111111111111111111111111111111111111111111111111111111111111111111111111111111111111111111111111111111111111111111111111111111111111111
         111111111111111111111111
  111    100000000011000000000001
  101    101100000111000000000001
  111    100100000000000000000001
         111111111111111111111111
111111111111000001110000000000001
100000000011000001110111111111111
11110111110000000100000010001    
11110110000000000010100100001    
11000001111110000000000010001    
10000000000000000110000001001  
11000001110101011111011110001  
11110111 1110101 101111010001    
11011111 1111111 111111111111    
11111
