NO ./texture_XPM/north.xpm                       
SO ./texture_XPM/south.xpm 

F 93, 93, 93
WE ./texture_XPM/west.xpm
C  0, 96, 255
EA ./texture_XPM/east.xpm 


111111111111111111111111111111111
100000000000000000000000000000001
111111111111111111111111111111111
         111111111111111111111111
  111    100000000011000000000001
  101    101100000111000000000001
  111    100100000000000000000001
         111111111111111111111111
111111111111000001110000000000001
100000000011000001110111111111111
11110111110000000100000010001    
11110110000000N00010100100001    
11000001111110000000000010001    
10000000000000000110000001001    
10000000000000001101010010001    
11000001110101011111011110001    
11110111 1110101 101111010001    
11111111 1111111 111111111111    
